* Afrikaans - af
* Albanian - sq
* Amharic - am 
* Armenian - hy 
* Arabic - ar
* Azerbaijani - az
* Bashkir - ba 
* Bengali - bn
* Bosnian - bs
* Basque - eu 
* Belarusian - be
* Bulgarian - bg 
* Catalan - ca 
* Chichewa - ny
* Chinese - zh-CN or zh-TW
* Corsican - co
* Croatian - hr
* Czech - cs
* Danish - da 
* Dutch - nl 
* English - en 
* Esperanto - eo 
* Estonian - et 
* Faeroese - fo
* Farsi - fa 
* Fijian - fj
* Finnish - fi 
* French - fr 
* Frisian - fy 
* Gaelic (Scotland) - gd 
* Galician - gl 
* Georgian - ka 
* Gujarati - gu 
* German - de 
* Greek - el 
* Haitian - ht
* Hausa - ha
* Hebrew - he
* Hindi - hi
* Hungarian - hu
* Icelandic - is
* Igbo - ig 
* Indonesian - id
* Irish - ga
* Italian - it
* Japanese - ja
* Javanese - jw
* Kannada - kn
* Kazakh - kk
* Khmer - km 
* Kinyarwanda - rw
* Kyrgyz - ky 
* Korean - ko 
* Kurdish - ku
* Lao - lo
* Latin - la
* Latvian - lv
* Lithuanian - lt
* Luxembourgish - lb
* Macedonian - mk
* Malagasy - mg
* Malayalam - ml
* Malaysian - ms
* Maltese - mt
* Maori - mi
* Marathi - mr
* Mongolian - mn
* Myanmar - my
* Nepali - ne
* Norwegian - no
* Norwegian - Bokmal - nb
* Oriya - or 
* Pashto - ps 
* Polish - pl
* Portuguese - pt
* Punjabi - pa 
* Rhaeto-Romanic - rm 
* Romanian - ro 
* Russian - ru 
* Samoan - sm 
* Serbian - sr 
* Sesotho - st 
* Shona - sn 
* Sindhi - sd
* Sinhala - si
* Slovak - sk
* Slovenian - sl
* Somali - so 
* Sorbian - sb
* Spanish - es
* Sundanese - su
* Swahili - sw
* Swedish - sv
* Tagalog - tl
* Tahitian - ty
* Tajik - tg
* Tamil - ta
* Tatar - tt
* Telugu - te
* Thai - th 
* Tongan - to
* Tsonga - ts 
* Tswana - tn 
* Turkish - tr
* Turkmen - tk
* Uighur - ug
* Ukrainian - uk
* Urdu - ur
* Uzbek - uz
* Venda - ve
* Vietnamese - vi
* Welsh - cy
* Xhosa - xh
* Yiddish - yi 
* Yoruba - yo 
* Zulu - zu 
